+----------------------------------------------------+
|                                                    |
|      +------------ ----+                           |
|               |        |                           |
|      |        |                +----- -------+     |
|      |                 |       |   +----+    |     |
|      +---- ------------+                |          |
|                        |       |   |    |    |     |
|      +------------- ---+       +- ----- +----+     |
|      |        |        |                |          |
|      +----- -----------+           |    |          |
|                          +-- -+  +------+ ---+     |
|       +----- -------+         |  | |    |    |     |
|       |             |    |    |    |    +------ ---+
+- -- ------ ----+    |         |  | |    |    |     |
|       |        |         |    |  | +- --+          |
|       +--- ------- -+    +----+  |                 |
|                |                 |           |     |
|                    +---  ------+ |           |     |
|     +----- ----|   |           | |           |     |
|     |         ||   +----- -----+ |           |     |
|     +----------|                 +--- -------+     |
|                                                    |
+----------------------------------------------------+
