wwwwwwwwwwwwwwwwwwwwwwwwwwwwwwwwwwwwwwwwwwwwwwwwwwwwwwwwwwwwwwwwwwwwwwwwwwwwwwwwwwwwwwwwwwwwwwwwwwwwwwwwwwwwwwwwwwwwwwwwwwwwwwwwwwwwwwwwwwwwwwwwwwwwwwwwwwwwwwwwwwwwwwwwwwwwwwwwwwwwwwwwwwwwwwwwwwwwwwwwww
w                                                          ###         ######                                                                                                                            w
w                                               #####os###oss####################                                                                                                                        w
w                                 #            ##oyh##########              ##                                           ###########                                                                     w
w               ####            ##o###### #oys#o#######       ##          ####                  ###               #########        ####################### #                                             w
w         ########################sd####o#so####o########    ###      #######               ############################                      ####     ###################                               w
w      #####                        #    #####o##########    #      ###   ######          ###  ##   ###o####          ##                                                #o####                           w
w    #####  ####       OH CANADA       ##### ##########      #####         ###         ##    #######  ##                                                         ####  #####                             w
w    o##o# ## #####                   ##########   ####        #                  ##    #### ## so##                                                       ####### ######                                w
w  ######       #h#                    #### ###      ###                        ##o##    ##s#####                                                         ####     ######                                w
w                ##                       ###        ####                      #HABLAND ## ###                             MOTHER RUSSIA                   ####s#    ####                                w
w                oy#               ####         #o###o###                         o###                                                                         #os#                                      w
w               ###     USA        ##sh#t      ##### ###                          ###       #       ######    ####                                             ###o#                                     w
w              ##                  #o##s### ######                             ###### ###   ####    # ######  #####                                                                                      w
w             #                       #  ####                                  #########   ###o######## ####    # ##                                                                                     w
w             #                                                                ##########  #s#  ######  ##      ####                                        #### #####                                   w
w             ###                                                              #####       ###  ####   ###                                               ##  ###syo###                                   w
w                           ##      ##                                        ##            ## ###### ###        ##                                       ###   ##                                       w
w                         ###      ####                                     ##                          ##      ######                                     ##                                            w
w                s###    ##        ##s##                                  ##                            ####     #####o#######                            ####                                           w
w                 # ##   #       #######                                 ##                                            ##    ####          #        ###     ##                                           w
w                   ###  #####      #o##o### ###                          o           AFRICA                         ###       ##          ###     ###s#     ##                                          w
w                      ####   #    DRUGLAND  ###                     ##  ##                                ####   ####          ##  ###      ###     ##     ###                                          w
w                           ###        ####   ###                        ##                                  #s#####             ## ##         ELECTRONICS LAND                                          w
w                              ###     #s ######                          ###                                 ######              ####         #h# ####    #o##yy#                                       w
w                                ###           #####                        ##   #######                         ##             #  ##o#       ###o##      ### ####    #             #        #           w
w                                   #              ###                        ######   ####                     ##              #             ######    ### #                                            w
w                                 ##                #o##                                                                                        ###s  #o#   ##o## h# #                    #   #          w
w                                 ##                #########                            ##                                                      ##### #########  ###s#######   ##        #              w
w                                 #                         ###                           ##                          #                           ####### #  s##     #####  ########                     w
w                                  ##                         #                            ##              ##                                       ##############      ######### #os##          #       w
w                                   ##      SAUF  AMERICA   ###                             #               ###   #                                          # ##  #####  ##  ###    ##          #       w
w                                    ##                     #                              ##               ######o                                            ###### ##  ###            ##          ##  w
w                                      ###                  #                              #              ### #####                                          ###       #### #            ##    #o#  ##   w
w                                                                                          ##            ##   ## #    ##                                                    ###       ###          #     w
w                                        ##            #####                                ##          ##    # ##                                      ##                   ###       ##                w
w                                         #            #                                     #         ##     ###                                       #      BBQLAND         #                         w
w                                         #           ##                                     ##       ##                                               ##                     ##                         w
w                                         #                                                   ## ######                                                ## #########         ###                          w
w                                         ##       o##                                         #####                                                   #####      ####    ###           ##               w
w                                         ##     ###                                                                                                                #######            ####              w
w                                         ###   ##                                                                                                                   ####          ######                w
w                                                                                                                                                                    ###        ######                   w
w                                          ###  ##                                                                                                                             ####                      w
w                                            ## #                                                                                                                                                        w
w                                             ##s###                                                                                                                                                     w
w                                                                                                                                                                                                        w
w                                                                                                                                                                                                        w
w                      ################                                                                                                                                                                  w
w                #####  o        #    #####                                                                                                                                                              w
w             ###    #    O  #         #   ###                                                                                                                                                           w
w          ###     ######       #             ###                                                                                                                                                        w
w        ####   ###########       #######   #    ##                                                                                                                                                      w
w      #####  ##############     #########         ##                                                                                                                                                    w
w     ####  o ##############     #########     O     #                                                                                                                                                   w
w    #        ##############  #   ######### ##     #  #                                                                                                                                                  w
w   ##  o      ###########   #  ##  ###########     ## #                                                                                                                                                 w
w  ####      #   ###### o       #  ############# o #### #                                                                                                                                                w
w ######                  # #      ##############  ##### #                                                                                                                                               w
w ######    O    #####  #        #  #############   ###  #                                                                                                                                               w
w# #####        #####       o        ########### ###    # #  Da Moon                                                                                                                                     w
w## #### #  #  #    #    #            ##      # ######    #                                                                                                                                              w
w#   ##                         o    ##   #     ######    #                                                                                                                                              w
w                                                                                                                                                                                                        w
w#  #     #   # #       o              ##   o   #######   #                                                                                                                                              w
w#     #    #       #       ###       ####       ###      #                                                                                                                                              w
w #  #    #  #              ###     # ####     #    #    #                                                                                                                                               w
w # #  o       #  ####  #              ##  #           # #                                                                                                                                               w
w  #      ###    ######       #                   o     #                                                                                                                                                w
w   #    #####   #####    #        O          #        #                                                                                                                                                 w
w    # o  ###       # #  #  ##        #   #     ####  #                                                                                                                                                  w
w     #      #     # #######                   ####  #                                                                                                                                                   w
w      ##             ###      #                   ##                                                                                                                                                    w
w        ##    o     # # #           O     #     ##                                                                                                                                                      w
w          ###      #  #        o             ###                                                                                                                                                        w
w             ###          #         #     ###                                                                                                                                                           w
w                #####        #       #####                                                                                                                                                              w
w                     ################                                                                                                                                                                   w
wwwwwwwwwwwwwwwwwwwwwwwwwwwwwwwwwwwwwwwwwwwwwwwwwwwwwwwwwwwwwwwwwwwwwwwwwwwwwwwwwwwwwwwwwwwwwwwwwwwwwwwwwwwwwwwwwwwwwwwwwwwwwwwwwwwwwwwwwwwwwwwwwwwwwwwwwwwwwwwwwwwwwwwwwwwwwwwwwwwwwwwwwwwwwwwwwwwwwwwwww